W...E......
B..P.I.....
I..R.......
X.R........
S.L..I.....
..X........